{
  "cols": 6,
  "rows": 5,
  "tiles": [
      "#","#","#","#","#","#",
      "#"," ","1"," "," ","#",
      "#"," ","2"," ","1","#",
      "#"," ","1"," ","2","#",
      "#","#","#","#","#","#"
  ]
}