{
  "cols": 9,
  "rows": 6,
  "tiles": [
      "#","#","#","#","#","#","#","#","#",
      "#","#","2"," ","1"," "," ","3","#",
      "#"," ","3"," ","2"," "," ","#","#",
      "#"," ","1","2","1","2"," ","#"," ",
      "#","#","#","#","#","#"," ","#"," ",
      " "," "," "," "," ","#","#","#"," "
  ]
}