{
  "cols": 10,
  "rows": 12,
  "tiles": [
      "#","#","#","#","#","#","#","#","#","#",
      "#"," "," ","9"," ","8"," "," "," ","#",
      "#"," "," ","1","2","3"," "," "," ","#",
      "#"," "," ","4","#","5"," "," "," ","#",
      "#"," "," ","#","#","#"," "," ","8","#",
      "#","2","9","7"," "," "," ","4","3","#",
      "#","1","#","4"," "," ","6","#","4","#",
      "#","#","#","#"," "," ","#","#","#","#",
      "#"," "," "," ","5"," ","5"," "," ","#",
      "#"," "," "," ","7","#","6"," "," ","#",
      "#"," "," "," ","#","#","#"," "," ","#",
      "#","#","#","#","#","#","#","#","#","#"
  ]
}